      ________________________________________________________________________________________________________ITA
     |  |              |                             |     |  |     |     |     |           |     |     |XX XX|
     |  |  ______   ___|__   ______   ___      ______|  ___|  |     |  ___|__   |     ______|__   |  ___|  ___|
     |  |     |  |                 |  |  |  |     |              |     |     |     |     |     |XX XX XX XX   |
     |  |__   |  |_____      ______|__|  |__|_____|     _________|__   |__   |  ___|_____|  ___|  _________   |
     |     |           |  |        |     |        |  |  |        |              |     |  |  |   XX|  |  |  |  |
     |  ___|_____      |__|     ___|__   |__   ___|__|__|__      |________   ___|__   |  |  |__   |  |  |  |__|
     |           |  |  |     |                       |  |     |                 |              |XX   |        |
     |  _________|  |__|__   |  _______________      |  |_____|_____   ___      |  ___         |  ___|__      |
     |     |        |        |  |        |  |     |  |  |  |  |     |     |  |  |  |     |  |  |XX XX      |  |
     |__   |  ______|__      |__|__   ___|  |_____|  |  |  |  |  ___|  ___|__|__|__|_____|__|  |__   ______|  |
     |  |  |     |  |     |        |  |        |                 |     |           |  |  |   XX XX XX|     |  |
     |  |  |_____|  |__   |  ______|  |_____   |________   ______|__   |  _________|  |  |__   ___   |     |__|
     |  |  |        |     |              |     |        |           |     |      XX XX XX XX XX   |  |  |     |
     |  |  |  ______|     |_____   ______|__   |__   ___|________   |  ___|__            _________|__|__|__   |
     |     |        |  |  |  |  |           |  |      XX XX|                 |  |XX|  |  |        |  |  |     |
     |  ___|_____   |__|__|  |  |  ______   |  |__         |___________   ___|__|  |__|__|__   ___|  |  |__   |
     |              |                    |     |     |XX|XX XX XX XX XX XX XX XX XX      |  |  |  |     |     |
     |_____   ______|  ______   ______   |_____|  ___|  |__   _____________________   ___|  |  |  |  ___|  ___|
     |     |     |  |     |     |  |  |     |        |XX|        |              |           |     |           |
     |  ___|  ___|  |  ___|__   |  |  |_____|________|  |__      |     _________|___________|__   |     ___   |
     |  |           |        |  |  |XX XX XX XX XX|  |XX   |  |  |  |           |        |           |  |     |
     |  |_____      |________|__|  |  _________   |  |  ___|  |  |  |_____   ___|  ______|     ______|__|__   |
     |     |  |  |     |         XX XX|  |      XX XX XX|     |  |  |        |     |        |     |           |
     |  ___|  |  |__   |________   ___|  |__         ___|__   |__|  |________|     |     ___|_____|  ______   |
     |        |  |        |     |XX|  |     |  |  |  |              |  |        |  |  |           |     |     |
     |_____   |  |_____   |__   |  |  |  ___|__|  |__|___________   |  |  ______|__|__|  ______   |_____|  ___|
     |           |  |        |XX XX|     |              |     |              |                 |  |  |  |     |
     |  ______   |  |__   ___|     |  ___|_____   ______|  ___|__   ___      |     ____________|  |  |  |__   |
     |  |     |  |     |     |XX|     |  |     |  |              |     |  |  |  |  |              |  |     |  |
     |__|  ___|  |  ___|__   |  |     |  |  ___|  |__      ______|     |  |__|  |__|     ___   ___|  |__   |  |
     |     |     |           |XX|  |           |  |  |  |        |  |  |        |  |  |     |  |        |     |
     |__   |  ___|__   ___   |  |__|________   |  |  |__|__   ___|  |  |_____   |  |  |__   |__|  ______|__   |
     |     |        |  |  |  |XX|  |     |     |  |  |     |        |  |        |        |  |     |  |     |  |
     |__   |________|  |  |__|  |  |  ___|  ___|  |  |__   |  ___   |__|__   ___|__   ___|__|  ___|  |     |__|
     |        |XX XX XX XX XX XX      |     |     |     |  |     |  |     |  |  |  |     |        |     |     |
     |__   ___|     ___   ____________|_____|__   |  ___|  |     |__|  ___|__|  |  |__   |     ___|  ___|_____|
     |      XX XX|  |     |        |     |           |  |     |     |     |        |     |  |        |  |     |
     |        ___|  |__   |__   ___|  ___|_____      |  |  ___|     |     |     ___|  ___|__|        |  |__   |
     |  |  |XX   |     |     |     |     |        |     |  |  |  |  |  |     |  |        |     |  |           |
     |  |__|  ___|_____|  ___|__   |  ___|_____   |  ___|__|  |__|  |  |_____|__|__   ___|  ___|__|__   ___   |
     |     |XX XX|     |  |           |  |  |     |        |  |                 |                 |  |     |  |
     |_____|     |     |__|  _________|  |  |__   |_____   |  |     _________   |_____            |  |_____|  |
     |  |  |  |XX XX|           |  |           |  |     |     |  |  |     |  |  |  |  |  |  |  |        |     |
     |  |  |  |__   |_____      |  |  ___   ___|__|  ___|     |__|  |  ___|  |__|  |  |__|  |__|__      |  ___|
     |           |XX|  |  |  |     |  |              |  |  |  |     |  |     |  |  |     |  |        |  |  |  |
     |___________|  |  |  |__|_____|__|__            |  |__|  |__   |  |     |  |  |  ___|__|  ______|__|  |  |
     |XX XX XX   |XX   |                    |  |  |              |     |  |  |                 |              |
     |  ___   ___|     |__      _________   |__|__|  ___   ___   |__   |  |__|        _________|  _________   |
     |XX   |XX XX XX|  |     |  |              |     |        |     |     |     |  |  |                 |     |
Start|_____|________|__|_____|__|______________|_____|________|_____|_____|_____|__|__|_________________|_____|
