      ________ITA
     |XX XX XX|
     |  ______|
     |XX|  |  |
     |  |  |  |
     |XX XX XX|
     |  ___   |
     |  |XX XX|
     |__|  ___|
     |XX XX|  |
     |  ___|  |
     |XX   |  |
     |  ___|  |
     |XX XX XX|
     |__      |
     |  |  |XX|
     |  |__|  |
     |  |  |XX|
     |  |  |  |
     |  |   XX|
     |  |__   |
     |     |XX|
     |     |  |
     |  |   XX|
     |__|__   |
     |   XX XX|
     |__   ___|
     |   XX XX|
     |_____   |
     |     |XX|
     |  ___|  |
     |   XX XX|
     |__   ___|
     |XX XX|  |
     |  ___|  |
     |XX   |  |
     |  ___|  |
     |XX XX|  |
     |__   |  |
     |  |XX XX|
     |  |__   |
     |     |XX|
     |__   |  |
     |  |   XX|
     |  |__   |
     |XX XX XX|
     |  ______|
     |XX      |
     |  ___   |
     |XX XX|  |
     |__   |__|
     |  |XX XX|
     |  |__   |
     |XX XX XX|
     |        |
     |XX|  |  |
     |  |__|  |
     |XX XX|  |
     |     |__|
     |  |XX XX|
     |__|     |
     |  |  |XX|
     |  |__|  |
     |      XX|
     |  ___   |
     |  |   XX|
     |  |__   |
     |  |  |XX|
     |__|  |  |
     |  |XX XX|
     |  |  ___|
     |XX XX   |
     |  ______|
     |XX XX|  |
     |     |  |
     |  |XX XX|
     |__|__   |
     |   XX XX|
     |__   ___|
     |  |XX   |
     |  |  ___|
     |XX XX|  |
     |  ___|  |
     |XX|     |
     |  |  ___|
     |XX|     |
     |  |__   |
     |XX|     |
     |  |__   |
     |XX   |  |
     |     |  |
     |XX|     |
     |  |  ___|
     |XX|     |
     |  |_____|
     |XX|     |
     |  |__   |
     |XX XX XX|
     |_____   |
     |  |   XX|
     |  |__   |
     |   XX XX|
     |__   ___|
     |   XX|  |
     |__   |  |
     |   XX XX|
     |_____   |
     |     |XX|
     |  ___|  |
     |     |XX|
     |__   |  |
     |      XX|
     |_____   |
     |   XX XX|
     |     ___|
     |  |XX XX|
     |__|__   |
     |     |XX|
     |     |  |
     |  |XX XX|
     |__|     |
     |   XX|  |
     |     |__|
     |  |XX|  |
     |  |  |  |
     |  |XX XX|
     |__|__   |
     |  |XX XX|
     |  |  ___|
     |   XX   |
     |__   ___|
     |  |XX   |
     |  |  ___|
     |   XX   |
     |__      |
     |XX XX|  |
     |  ___|  |
     |XX|  |  |
     |  |  |__|
     |XX XX XX|
     |        |
     |  |  |XX|
     |__|__|  |
     |   XX XX|
     |     ___|
     |  |XX   |
     |  |  ___|
     |  |XX XX|
     |__|__   |
     |     |XX|
     |     |  |
     |  |XX XX|
     |__|  ___|
     |  |XX|  |
     |  |  |  |
     |  |XX|  |
     |  |  |  |
     |XX XX   |
     |  ______|
     |XX|     |
     |  |     |
     |XX|  |  |
     |  |__|  |
     |XX XX   |
     |__   ___|
     |   XX XX|
     |_____   |
     |XX XX XX|
     |  ___   |
     |XX   |  |
     |  ___|__|
     |XX XX XX|
     |_____   |
     |     |XX|
     |  ___|  |
     |  |   XX|
     |  |__   |
     |      XX|
     |_____   |
     |     |XX|
     |__   |  |
     |   XX XX|
     |     ___|
     |  |XX|  |
     |__|  |  |
     |XX XX|  |
     |     |  |
     |XX|     |
     |  |__   |
     |XX XX|  |
     |__   |__|
     |XX XX|  |
     |  ___|  |
     |XX|     |
     |  |     |
     |XX XX|  |
     |__   |__|
     |XX XX   |
     |  ___   |
     |XX|     |
Start|__|_____|
