      _____________________________ITA
     |     |  |     |            XX|
     |  ___|  |  ___|_____   ___   |
     |     |  |           |     |XX|
     |  ___|  |________   |__   |  |
     |     |  |  |  |           |XX|
     |  ___|  |  |  |___________|  |
     |                  XX XX XX XX|
     |  _______________   ___      |
     |  |     |      XX XX|  |  |  |
     |__|     |_____   ___|  |  |__|
     |     |        |XX|  |  |  |  |
     |__   |__      |  |  |  |__|  |
     |     |     |   XX|           |
     |  ___|__   |__   |  ___      |
     |  |        |   XX XX|  |  |  |
     |__|  ___   |  ___   |  |__|__|
     |  |     |  |  |   XX   |     |
     |  |     |  |__|__   ___|__   |
     |     |  |  |     |XX XX   |  |
     |  ___|__|  |  ___|__      |  |
     |  |  |     |   XX XX XX|     |
     |__|  |  ___|__   ___   |_____|
     |  |  |        |XX|  |  |     |
     |  |  |  ______|  |  |__|__   |
     |     |  |XX XX XX            |
     |__   |__|     ___   _________|
     |      XX XX|  |        |     |
     |        ___|  |__   ___|  ___|
     |  |  |XX   |     |     |     |
     |  |__|  ___|_____|_____|__   |
     |     |XX XX|        |        |
     |_____|     |     ___|  ______|
     |     |  |XX XX|        |     |
     |  ___|__|__   |        |  ___|
     |           |XX|  |  |        |
     |________   |  |__|  |__   ___|
     |XX XX XX|   XX|        |     |
     |        |__   |  ___   |     |
     |XX|  |XX XX XX|     |  |  |  |
Start|__|__|________|_____|__|__|__|
