      ____________________________________________ITA
     |     |  |  |   XX XX XX|        |XX XX XX XX|
     |  ___|  |  |__         |  ______|  ___   ___|
     |     |     |   XX|  |XX XX XX|   XX   |     |
     |  ___|  ___|__   |  |  ___   |__   ___|__   |
     |      XX XX XX XX|  |     |XX XX XX   |     |
     |_____   _________|__|  ___|  _________|__   |
     |  |   XX|        |  |     |  |  |  |     |  |
     |  |__   |     ___|  |  ___|__|  |  |__   |  |
     |      XX   |        |     |     |        |  |
     |_____   ___|__   ___|  ___|     |_____   |  |
     |      XX   |     |     |     |        |     |
     |  ___   ___|__   |_____|     |__      |__   |
     |  |  |XX|  |  |  |        |  |     |        |
     |  |  |  |  |  |__|_____   |__|__   |_____   |
     |  |   XX|     |  |  |  |     |     |  |     |
     |__|__   |__   |  |  |  |_____|__   |  |  ___|
     |      XX|     |  |  |                 |     |
     |        |     |  |  |        _________|     |
     |  |  |XX|  |  |        |  |  |  |  |     |  |
     |__|__|  |__|  |________|__|__|  |  |__   |  |
     |  |  |XX|           |     |     |        |  |
     |  |  |  |________   |__   |     |__   ___|  |
     |     |XX|              |     |     |  |     |
     |__   |  |  ___   ___   |__   |_____|__|     |
     |XX XX XX   |  |  |              |  |  |  |  |
     |     ___   |  |__|  ____________|  |  |__|__|
     |XX|  |        |           |     |           |
     |  |__|        |__   ___   |__   |__         |
     |XX   |  |  |  |     |  |  |  |     |  |  |  |
     |     |__|__|__|     |  |__|  |     |__|__|  |
     |XX|     |        |  |           |     |     |
     |  |_____|  ______|  |  ______   |_____|     |
     |XX   |  |  |     |  |  |           |  |  |  |
     |  ___|  |__|  ___|__|  |__   ___   |  |__|  |
     |XX XX XX XX XX XX XX|  |     |              |
     |__   ______         |  |_____|________   ___|
     |  |     |  |  |  |XX|  |  |  |  |           |
     |  |  ___|  |__|__|  |  |  |  |  |  _________|
     |  |        |      XX|  |        |     |     |
     |  |__      |_____   |__|  ______|__   |     |
     |  |     |  |  |   XX|                 |  |  |
     |  |_____|  |  |__   |___________   ___|__|  |
     |        |     |   XX XX XX XX XX XX XX XX   |
     |_____   |_____|__   ___   ____________   ___|
     |        |              |        |   XX XX|  |
     |     ___|  ___   ______|__   ___|     ___|  |
     |  |        |        |           |  |XX XX XX|
     |  |________|__   ___|_____      |__|_____   |
     |     |  |           |  |     |  |  |      XX|
     |  ___|  |___________|  |  ___|__|  |_____   |
     |  |              |     |  |   XX XX XX XX XX|
     |  |_____      ___|__   |__|__   _________   |
     |        |  |     |         XX XX|  |        |
     |__   ___|  |__   |________   ___|  |__      |
     |        |  |        |     |XX|  |     |  |  |
     |________|  |  ___   |__   |  |  |  ___|__|__|
     |  |  |  |  |  |        |XX XX|           |  |
     |  |  |  |  |__|__   ___|     |  ______   |  |
     |  |     |  |     |     |XX|     |  |  |  |  |
     |  |__   |  |  ___|__   |  |     |  |  |__|  |
     |     |     |           |XX|  |              |
     |__   |  ___|__   ___   |  |__|________      |
     |     |        |  |  |  |XX|  |     |     |  |
     |__   |________|  |  |__|  |  |  ___|  ___|__|
     |     |  |XX XX XX XX XX XX      |        |  |
     |__   |  |     ___   ____________|________|  |
     |      XX XX|  |     |        |     |  |     |
     |        ___|  |__   |__   ___|  ___|  |     |
     |  |  |XX   |     |     |     |     |     |  |
     |  |__|  ___|_____|  ___|__   |     |__   |  |
     |     |XX XX|     |  |           |  |  |  |  |
     |_____|     |     |__|        ___|  |  |  |__|
     |        |XX XX|        |  |  |        |  |  |
     |________|__   |_____   |__|  |__   ___|  |  |
     |  |         XX|  |     |        |     |  |  |
     |  |_____      |  |  ___|  ___   |     |  |  |
     |XX XX XX|  |XX|     |     |     |  |     |  |
     |  ___   |__|  |__   |  ___|_____|__|__   |  |
     |XX|   XX XX XX|     |              |        |
Start|__|___________|_____|______________|________|
